[level]
map = ..........................................................
      .^^^^^^^^^................................................
      .^#######^^^..............................................
      .^#~~~~~###^.................................^^^^^^^^^^^^.
      .^#~~~~~~~#^.................................^##########^.
      .^#~~~~####^.................................^#~~~~~~~~#^.
      .^######^^^^.....^^^^^^^.....................^##~~~~~~~#^.
      .^^^^^^^^.......^^#####^^^^..................^^#########^.
      ................^##~~~####^...................^^^^^^^^^^^.
      ................^#~~~~~~~#^...............................
      ................^#~~~~~~~#^...............................
      ................^##~~~~~##^...............................
      ................^^#######^^...............................
      .................^^^^^^^^^................................
      ..........................................................
      ....................................^^^^^^^^^^^^..........
      ....................................^##########^..........
      ....................................^#~~~~~~~~#^..........
      ....................................^#~~~~~~~~#^..........
      ....................................^#~~~~~~~~#^..........
      ....................................^##########^..........
      ...................^^^^^^^^^^^......^^^^^^^^^^^^..........
      ...................^#########^............................
      ...................^#~~~~~~~#^............................
      ...................^#~~~~~~~#^............................
      ...................^#~~~~~~~#^............................
      ...................^#########^............................
      .^^^^^^^^^^^^......^^^^^^^^^^^............................
      .^##########^.............................................
      .^#~~~~~~~~#^.............................................
      .^#~~~~~~~~#^.............................................
      .^#~~~~~~~~#^.............................................
      .^##########^.............................................
      .^^^^^^^^^^^^.............................................
      ..........................................................

[player]
coords = 10,8

[.]
name = water
complex = no

[#]
name = sand
complex = yes

[~]
name = grass
complex = no

[^]
name = beach
complex = yes
