[level]
map = ....................................................................................................................
      .^^^^^^^^^.............................................................^^^^^^^^^^^^^^^^^^^^^^^^^^^^^^^^^^^^^^.......
      .^#######^^^...........................................................^####################################^.......
      .^#~~~~~###^.................................^^^^^^^^^^^^.........M....^#c~~~~~~~~~~~~~~~~~~~~~~~~~~~~~~~~~#^.......
      .^#~~~~~~c#^..................S..............^##########^..............^########~~~~~~~~~~~~~~~~~~~~~~~~~~~#^^^^....
      .^#~~c~####^............................M....^#c~~~~c~~#^..............^^^^^^^^#~~~~~~~~~~~~~~~~~~~~~~~~~~~####^....
      .^######^^^^.....^^^^^^^.....................^##~~c~~~~#^.....................^#c~~~~c~~~~~~~~~~~~~~~~~~~~~~~c#^....
      .^^^^^^^^.......^^#####^^^^..................^^#########^...............❤.....^##########~~~~~~~~~~~~~~~~~~~~~#^....
      ................^##~~c####^...................^^^^^^^^^^^.....................^^^^^^^^^^#~~~~~~~~~~~~~~~~~~~~~#^....
      ................^#c~~~~~~#^............................................................^#c~~~~~~~~~~~~~~~~~~~~#^....
      ................^#~~~~~~c#^.......❤....................................................^#~~~c~~~~~~c~~~~~~~~c~#^....
      ................^##~~c~~##^.....................^^^^^^^^^^^^...........................^#######################^....
      ................^^#######^^............S........^##########^...........................^^^^^^^^^^^^^^^^^^^^^^^^^....
      .................^^^^^^^^^......................^#c~~~~~~c#^........................................................
      ................................................^#~~~~~~~~#^....................S...........M.......................
      ......★.............................^^^^^^^^^^^^^#~~~~~~~~#^........................................................
      .....................M..............^#############~~~~~~~c#^........................................................
      ....................................^#~c~~~~~c~~~~~~~~~####^........................S...............................
      ....................................^#~~~~~~~~~~~~~~~~~#^^^^............❤...........................................
      ....................................^#~~c~~~~~~~~c~~~~c#^.......................................^^^^^^^^^^^^........
      ...........S........................^###################^.......................................^##########^........
      ...................^^^^^^^^^^^......^^^^^^^^^^^^^^^^^^^^^.......................................^#c~~~~~~~#^........
      ...................^#########^......................................^^^^^^^.....................^##~~c~~~~#^........
      ...................^#c~~~~~~#^.....................................^^#####^^^^..................^^#########^........
      ...................^#~~~~~~c#^........❤............................^##~~~####^...................^^^^^^^^^^^........
      .............M.....^#~c~~~~~#^.....................................^#c~~~~~~#^......................................
      ...................^#########^.....................................^#~~~~~~c#^..................❤...................
      .^^^^^^^^^^^^......^^^^^^^^^^^....................S................^##~~c~~##^......................................
      .^##########^......................................................^^#######^^......................................
      .^#~~c~~~~~#^.......................................................^^^^^^^^^................S........M.............
      .^#~~~~~~~c#^.......................................................................................................
      .^#~~~~~~~~#^.......................^^^^^^^^^...........................M.........................^^^^^^^^^^^^......
      .^##########^............S...^^^^^^^^#######^^^^^^^^^^............................................^##########^......
      .^^^^^^^^^^^^................^########~~c~~##########^............................................^#~~c~~~~~#^......
      .............................^#~~c~~~~~~~~~~~~~~~~~~#^............................................^#~~~~~~~~#^......
      ...................❤.........^#~~~~~~~~~~~~~~~~~~~~c#^...........................S................^#~~c~~~~c#^......
      .............................^#c~~~~~~~~c~~~~~~~~~~~#^............................................^##########^......
      .............................^#~~~###################^.......❤........^^^^^^^^^^^.................^^^^^^^^^^^^......
      .........S...................^#####^^^^^^^^^^^^^^^^^^^................^#########^...................................
      .............................^^^^^^^..................................^#c~~~~~~#^...................................
      ........................................M.............................^#~~~~~~c#^.....M.............................
      ......................................................................^#~c~~~~~#^...................................
      ...................S..................................................^#########^...................................
      ....................................................^^^^^^^^^^^^......^^^^^^^^^^^...................................
      ....................................................^##########^....................................................
      ....................................................^#~~c~~~~~#^............................................S.......
      ....................................................^#~~~~~~~c#^....................................................
      ....................................................^#c~~~~~~~#^...........................S........................
      .............................S......................^##########^....................................................
      ....................................................^^^^^^^^^^^^....................................................
      ....................................................................................................................
[★]
name = player
complex = yes

[.]
name = water
complex = no

[#]
name = sand
complex = yes

[~]
name = grass
complex = no

[^]
name = beach
complex = yes

[c]
name = cannon
complex = yes
act_as = ~

[❤]
name = heart
complex = yes
act_as = .

[M]
name = medal
complex = yes
act_as = .

[S]
name = ship
complex = yes
act_as = .
