[level]
map = ..........................................................................
      .#########................................................................
      .#~~~~~~~#....................................##########..................
      .#~~~~~~~#....................................#~~~~~~~~#..................
      .#########....................................#~~~~~~~~#..................
      ................##########....................#~~~~~~~~#..................
      ................#~~~~~~~~#....................##########..................
      ................#~~~~~~~~#................................................
      ................#~~~~~~~~#................................................
      ................##########................................................
      ..........................................................................
      .....................................##########...........................
      .....................................#~~~~~~~~#...........................
      .....................................#~~~~~~~~#...........................
      .....................................#~~~~~~~~#...........................
      .....................................##########...........................
      ..........................................................................

[.]
name = water

[#]
name = sand

[~]
name = grass
