[level]
map = ..........................................................
      .#######..................................................
      .#~~~~~###....................................##########..
      .#~~~~~~~#....................................##########..
      .#~~~~####....................................#~~~~~~~~#..
      .######.......................................#~~~~~~~~#..
      .................#########....................#~~~~~~~~#..
      ................##~~~~~~~####.................##########..
      ................#~~~~~~~~~~~#.............................
      ................#~~~~~~~~~~~#.............................
      ................##~~~~~~~~~~##............................
      .................###~~~~~~~~~#............................
      ...................#~~~~~~~~~#............................
      ...................#~~~~~~~~~#............................
      ...................#~~####~~~#............................
      ...................####..#####.......##########...........
      .....................................#~~~~~~~~#...........
      .....................................#~~~~~~~~#...........
      .....................................#~~~~~~~~#...........
      .....................................##########...........
      ..........................................................
      ...................##########.............................
      ...................#~~~~~~~~#.............................
      ...................#~~~~~~~~#.............................
      ...................#~~~~~~~~#.............................
      ...................##########.............................
      ..........................................................
      .##########...............................................
      .#~~~~~~~~#...............................................
      .#~~~~~~~~#...............................................
      .#~~~~~~~~#...............................................
      .##########...............................................
      ..........................................................

[player]
coords = 10,8

[.]
name = water

[#]
name = sand

[~]
name = grass
